1;0;0;0;
19
27
0
32 32 32 32 32 32 32 0 0 0 0 0 32 32 32 32 32 32 32 
32 25 25 25 25 32 0 25 25 25 25 25 0 32 25 25 25 25 32 
32 25 25 25 25 32 0 25 25 25 25 25 0 32 25 25 25 25 32 
32 25 25 25 25 32 0 25 25 25 25 25 0 32 25 25 25 25 32 
32 25 25 25 25 32 56 25 25 25 25 25 54 32 25 25 25 25 32 
32 25 25 25 25 25 25 25 25 25 25 25 25 25 25 25 25 25 32 
32 25 25 25 25 25 10 25 25 25 25 25 10 25 25 25 25 25 32 
32 25 25 32 32 32 32 32 25 25 25 32 32 32 32 32 25 25 32 
32 25 32 32 32 32 32 32 32 25 32 32 32 32 32 32 32 25 32 
32 25 32 32 32 32 32 32 32 32 32 32 32 32 32 32 32 25 32 
32 25 32 32 32 32 32 32 32 32 32 32 32 32 32 32 32 25 32 
32 5 54 32 32 32 32 32 32 5 32 32 32 32 32 32 56 5 32 
32 5 5 0 54 32 32 32 32 5 32 32 32 32 56 0 5 5 32 
32 5 5 5 5 0 54 32 32 5 32 32 56 0 5 5 5 5 32 
32 5 5 5 5 5 5 32 32 5 32 32 5 5 5 5 5 5 32 
32 5 5 5 5 5 5 5 5 5 5 5 5 5 5 5 5 5 32 
32 5 25 5 5 5 5 32 32 32 32 32 5 5 5 5 25 5 32 
32 20 5 5 5 5 32 32 32 32 32 32 32 5 5 5 5 20 32 
32 32 32 5 32 32 32 32 32 32 32 32 32 32 32 5 32 32 32 
32 32 32 5 32 32 5 5 5 32 5 5 5 32 32 5 32 32 32 
32 32 5 5 5 32 5 5 5 32 5 5 5 32 5 5 5 32 32 
32 32 5 5 5 32 5 5 5 32 5 5 5 32 5 5 5 32 32 
0 5 5 5 5 32 5 32 32 32 32 32 5 32 5 5 5 5 0 
0 5 5 25 5 5 5 5 5 5 5 5 5 5 5 25 5 5 0 
0 5 5 5 5 5 5 5 5 5 5 5 5 5 5 5 5 5 0 
0 10 5 5 5 32 32 32 32 5 32 32 32 32 5 5 5 10 0 
32 0 0 0 0 32 32 32 32 32 32 32 32 32 0 0 0 0 32 
01110000
0 0 0 0 0 0 0 0 0 0 0 0 0 0 0 0 0 0 0 
0 0 0 0 0 0 0 0 0 0 0 0 0 0 0 0 0 0 0 
0 0 0 0 0 0 0 0 0 0 0 0 0 0 0 0 0 0 0 
0 0 0 0 0 0 0 0 0 0 0 0 0 0 0 0 0 0 0 
0 0 0 0 0 0 0 0 0 0 0 0 0 0 0 0 0 0 0 
0 0 0 0 0 0 0 0 0 0 0 0 0 0 0 0 0 0 0 
0 0 0 0 0 0 0 0 0 0 0 0 0 0 0 0 0 0 0 
0 0 0 0 0 0 0 0 0 0 0 0 0 0 0 0 0 0 0 
0 0 0 0 0 0 0 0 0 0 0 0 0 0 0 0 0 0 0 
0 0 0 0 0 0 0 0 0 0 0 0 0 0 0 0 0 0 0 
0 0 0 0 0 0 0 0 0 0 0 0 0 0 0 0 0 0 0 
0 0 0 0 0 0 0 0 0 0 0 0 0 0 0 0 0 0 0 
0 0 0 0 0 0 0 0 0 0 0 0 0 0 0 0 0 0 0 
0 0 0 0 0 0 0 0 0 0 0 0 0 0 0 0 0 0 0 
0 0 0 0 0 0 0 0 0 0 0 0 0 0 0 0 0 0 0 
0 0 0 0 0 0 0 0 0 0 0 0 0 0 0 0 0 0 0 
0 0 0 0 0 0 0 0 0 0 0 0 0 0 0 0 0 0 0 
0 0 0 0 0 0 0 0 0 0 0 0 0 0 0 0 0 0 0 
0 0 0 0 0 0 0 0 0 0 0 0 0 0 0 0 0 0 0 
0 0 0 0 0 0 0 0 0 0 0 0 0 0 0 0 0 0 0 
0 0 0 0 0 0 0 0 0 0 0 0 0 0 0 0 0 0 0 
0 0 0 0 0 0 0 0 0 0 0 0 0 0 0 0 0 0 0 
0 0 0 0 0 0 0 0 0 0 0 0 0 0 0 0 0 0 0 
0 0 0 0 0 0 0 0 0 0 0 0 0 0 0 0 0 0 0 
0 0 0 0 0 0 0 0 0 0 0 0 0 0 0 0 0 0 0 
0 0 0 0 0 0 0 0 0 0 0 0 0 0 0 0 0 0 0 
0 0 0 0 0 0 0 0 0 0 0 0 0 0 0 0 0 0 0 
01111010
5 9 9 22 22 
3 2 2 10 10 
3 16 16 10 10 
3 15 15 3 3 
3 3 3 3 3 
2 1 4 20 25 
2 14 17 20 25 
01101010
8 23
10 23
9 25
8 22
10 22
2 3
3 2
2 1
1 2
4 4
15 2
16 3
16 1
17 2
14 4
01100101
1 1 1 25 0
1 1 17 25 0
1 1 2 24 0
1 1 16 24 0
1 5 1 17 0
1 5 17 17 0
1 3 1 16 0
1 3 17 16 0
1 1 2 9 0
1 2 3 9 0
1 2 15 9 0
1 1 16 9 0
1 1 7 7 0
1 1 11 7 0
1 2 9 1 0
2 5 9 24 1
2 3 7 22 1
2 2 9 22 1
2 10 11 22 1
2 7 9 18 1
2 7 9 15 1
2 2 3 3 2
2 2 15 3 3
2 5 2 2 2
2 5 16 2 3
01111011
1 2 25
4 16 25
1 1 24
4 17 24
1 6 10
4 12 10
4 8 7
1 10 7
7777
Mapa przeznaczona do walki 1 vs 2. Gracz pierwszy wciela się w potężnego władce północy natomiast pozostali gracze próbują go pokonać.