1;6;0;0;
33
33
32 32 32 32 32 32 32 32 32 32 32 0 0 0 0 0 0 0 0 0 0 54 32 32 32 32 32 32 32 32 32 32 32 
32 32 32 32 32 32 32 32 32 32 56 5 5 5 5 5 5 10 5 5 5 5 54 32 32 32 32 32 32 32 32 32 32 
32 32 32 32 32 32 32 32 32 5 5 5 5 5 5 5 5 5 5 5 5 5 5 5 32 32 32 32 32 32 32 32 32 
32 32 32 32 32 32 32 32 32 32 50 5 5 5 5 5 5 5 5 5 5 5 48 32 32 32 32 32 32 32 32 32 32 
32 32 32 32 32 32 32 32 32 32 32 50 5 5 32 50 5 48 32 5 5 51 32 32 32 32 32 32 32 32 32 32 32 
32 32 32 32 32 32 32 32 32 32 56 5 5 5 5 32 32 32 5 5 5 5 54 32 32 32 32 32 32 32 32 32 32 
32 32 32 32 32 32 32 32 32 56 5 5 5 5 5 5 5 5 5 5 5 5 5 54 32 32 32 32 32 32 32 32 32 
32 32 32 32 32 32 32 32 56 5 5 5 5 5 5 5 5 5 5 5 5 5 5 5 54 32 32 32 32 32 32 32 32 
32 32 32 32 32 32 32 56 5 5 5 48 32 32 32 5 5 5 32 32 32 50 5 5 5 54 32 32 32 32 32 32 32 
32 32 5 32 32 32 56 5 5 5 48 32 32 32 32 32 5 32 32 32 32 32 50 5 5 5 54 32 32 32 5 32 32 
32 56 5 54 32 56 5 5 5 48 32 32 32 32 32 32 5 32 32 32 32 32 32 50 5 5 5 54 32 56 5 54 32 
0 5 5 5 55 5 5 5 48 32 32 32 32 32 32 5 5 5 32 32 32 32 32 32 50 5 5 5 55 5 5 5 54 
0 5 5 5 5 5 5 5 32 32 32 32 32 32 5 5 5 5 5 32 32 32 32 32 32 5 5 5 5 5 5 5 0 
0 5 5 5 5 5 5 5 32 32 32 32 32 20 5 5 5 5 5 20 32 32 32 32 32 5 5 5 5 5 5 5 0 
0 5 5 5 32 5 5 5 32 32 32 32 5 5 5 32 5 32 5 5 5 32 32 32 32 5 5 5 32 5 5 5 0 
0 5 5 5 54 32 5 5 5 32 32 5 5 5 32 32 5 32 32 5 5 5 32 32 5 5 5 32 56 5 5 10 0 
0 5 5 5 5 32 5 5 5 5 5 5 5 5 5 5 30 5 5 5 5 5 5 5 5 5 5 32 5 5 5 5 0 
0 10 5 5 48 32 5 5 5 32 32 5 5 5 32 32 5 32 32 5 5 5 32 32 5 5 5 32 50 5 5 5 0 
0 5 5 5 32 5 5 5 32 32 32 32 5 5 5 32 5 32 5 5 5 32 32 32 32 5 5 5 32 5 5 5 0 
0 5 5 5 5 5 5 5 32 32 32 32 32 20 5 5 5 5 5 20 32 32 32 32 32 5 5 5 5 5 5 5 0 
0 5 5 5 5 5 5 5 32 32 32 32 32 32 5 5 5 5 5 32 32 32 32 32 32 5 5 5 5 5 5 5 0 
0 5 5 5 49 5 5 5 54 32 32 32 32 32 32 5 5 5 32 32 32 32 32 32 56 5 5 5 49 5 5 5 0 
32 50 5 48 32 50 5 5 5 54 32 32 32 32 32 32 5 32 32 32 32 32 32 56 5 5 5 48 32 50 5 48 32 
32 32 5 32 32 32 50 5 5 5 54 32 32 32 32 32 5 32 32 32 32 32 56 5 5 5 48 32 32 32 5 32 32 
32 32 32 32 32 32 32 50 5 5 5 54 32 32 32 5 5 5 32 32 32 56 5 5 5 48 32 32 32 32 32 32 32 
32 32 32 32 32 32 32 32 50 5 5 5 5 5 5 5 5 5 5 5 5 5 5 5 48 32 32 32 32 32 32 32 32 
32 32 32 32 32 32 32 32 32 50 5 5 5 5 5 5 5 5 5 5 5 5 5 48 32 32 32 32 32 32 32 32 32 
32 32 32 32 32 32 32 32 32 32 50 5 5 5 5 32 32 32 5 5 5 5 48 32 32 32 32 32 32 32 32 32 32 
32 32 32 32 32 32 32 32 32 32 32 53 5 5 32 65 5 54 32 5 5 51 32 32 32 32 32 32 32 32 32 32 32 
32 32 32 32 32 32 32 32 32 32 56 5 5 5 5 5 5 5 5 5 5 5 54 32 32 32 32 32 32 32 32 32 32 
32 32 32 32 32 32 32 32 5 5 5 5 5 5 5 5 5 5 5 5 5 5 5 5 32 32 32 32 32 32 32 32 32 
32 32 32 32 32 32 32 32 32 32 50 5 5 5 5 5 5 10 5 5 5 5 48 32 32 32 32 32 32 32 32 32 32 
32 32 32 32 32 32 32 32 32 32 32 0 0 0 0 0 0 0 0 0 0 0 32 32 32 32 32 32 32 32 32 32 32 
01110000
0 0 0 0 0 0 0 0 0 0 0 0 0 0 0 0 0 0 0 0 0 0 0 0 0 0 0 0 0 0 0 0 0 
0 0 0 0 0 0 0 0 0 0 0 0 0 0 0 0 0 0 0 0 0 0 0 0 0 0 0 0 0 0 0 0 0 
0 0 0 0 0 0 0 0 0 0 0 0 0 0 0 0 0 0 0 0 0 0 0 0 0 0 0 0 0 0 0 0 0 
0 0 0 0 0 0 0 0 0 0 0 0 0 0 0 0 0 0 0 0 0 0 0 0 0 0 0 0 0 0 0 0 0 
0 0 0 0 0 0 0 0 0 0 0 0 0 0 0 0 0 0 0 0 0 0 0 0 0 0 0 0 0 0 0 0 0 
0 0 0 0 0 0 0 0 0 0 0 0 0 0 0 0 0 0 0 0 0 0 0 0 0 0 0 0 0 0 0 0 0 
0 0 0 0 0 0 0 0 0 0 0 0 0 0 0 0 0 0 0 0 0 0 0 0 0 0 0 0 0 0 0 0 0 
0 0 0 0 0 0 0 0 0 0 0 0 0 0 0 0 0 0 0 0 0 0 0 0 0 0 0 0 0 0 0 0 0 
0 0 0 0 0 0 0 0 0 0 0 0 0 0 0 0 0 0 0 0 0 0 0 0 0 0 0 0 0 0 0 0 0 
0 0 0 0 0 0 0 0 0 0 0 0 0 0 0 0 0 0 0 0 0 0 0 0 0 0 0 0 0 0 0 0 0 
0 0 0 0 0 0 0 0 0 0 0 0 0 0 0 0 0 0 0 0 0 0 0 0 0 0 0 0 0 0 0 0 0 
0 0 0 0 0 0 0 0 0 0 0 0 0 0 0 0 0 0 0 0 0 0 0 0 0 0 0 0 0 0 0 0 0 
0 0 0 0 0 0 0 0 0 0 0 0 0 0 0 0 0 0 0 0 0 0 0 0 0 0 0 0 0 0 0 0 0 
0 0 0 0 0 0 0 0 0 0 0 0 0 0 0 0 0 0 0 0 0 0 0 0 0 0 0 0 0 0 0 0 0 
0 0 0 0 0 0 0 0 0 0 0 0 0 0 0 0 0 0 0 0 0 0 0 0 0 0 0 0 0 0 0 0 0 
0 0 0 0 0 0 0 0 0 0 0 0 0 0 0 0 0 0 0 0 0 0 0 0 0 0 0 0 0 0 0 0 0 
0 0 0 0 0 0 0 0 0 0 0 0 0 0 0 0 0 0 0 0 0 0 0 0 0 0 0 0 0 0 0 0 0 
0 0 0 0 0 0 0 0 0 0 0 0 0 0 0 0 0 0 0 0 0 0 0 0 0 0 0 0 0 0 0 0 0 
0 0 0 0 0 0 0 0 0 0 0 0 0 0 0 0 0 0 0 0 0 0 0 0 0 0 0 0 0 0 0 0 0 
0 0 0 0 0 0 0 0 0 0 0 0 0 0 0 0 0 0 0 0 0 0 0 0 0 0 0 0 0 0 0 0 0 
0 0 0 0 0 0 0 0 0 0 0 0 0 0 0 0 0 0 0 0 0 0 0 0 0 0 0 0 0 0 0 0 0 
0 0 0 0 0 0 0 0 0 0 0 0 0 0 0 0 0 0 0 0 0 0 0 0 0 0 0 0 0 0 0 0 0 
0 0 0 0 0 0 0 0 0 0 0 0 0 0 0 0 0 0 0 0 0 0 0 0 0 0 0 0 0 0 0 0 0 
0 0 0 0 0 0 0 0 0 0 0 0 0 0 0 0 0 0 0 0 0 0 0 0 0 0 0 0 0 0 0 0 0 
0 0 0 0 0 0 0 0 0 0 0 0 0 0 0 0 0 0 0 0 0 0 0 0 0 0 0 0 0 0 0 0 0 
0 0 0 0 0 0 0 0 0 0 0 0 0 0 0 0 0 0 0 0 0 0 0 0 0 0 0 0 0 0 0 0 0 
0 0 0 0 0 0 0 0 0 0 0 0 0 0 0 0 0 0 0 0 0 0 0 0 0 0 0 0 0 0 0 0 0 
0 0 0 0 0 0 0 0 0 0 0 0 0 0 0 0 0 0 0 0 0 0 0 0 0 0 0 0 0 0 0 0 0 
0 0 0 0 0 0 0 0 0 0 0 0 0 0 0 0 0 0 0 0 0 0 0 0 0 0 0 0 0 0 0 0 0 
0 0 0 0 0 0 0 0 0 0 0 0 0 0 0 0 0 0 0 0 0 0 0 0 0 0 0 0 0 0 0 0 0 
0 0 0 0 0 0 0 0 0 0 0 0 0 0 0 0 0 0 0 0 0 0 0 0 0 0 0 0 0 0 0 0 0 
0 0 0 0 0 0 0 0 0 0 0 0 0 0 0 0 0 0 0 0 0 0 0 0 0 0 0 0 0 0 0 0 0 
0 0 0 0 0 0 0 0 0 0 0 0 0 0 0 0 0 0 0 0 0 0 0 0 0 0 0 0 0 0 0 0 0 
01111010
2 0 32 0 32 
2 0 32 0 32 
2 0 32 0 32 
2 0 32 0 32 
2 0 32 0 32 
2 0 32 0 32 
2 0 32 0 32 
2 0 32 0 32 
2 0 32 0 32 
2 0 32 0 32 
2 0 32 0 32 
2 0 32 0 32 
2 0 32 0 32 
2 0 32 0 32 
2 0 32 0 32 
2 0 32 0 32 
2 0 32 0 32 
2 0 32 0 32 
2 0 32 0 32 
2 0 32 0 32 
2 0 32 0 32 
2 0 32 0 32 
2 0 32 0 32 
2 0 32 0 32 
2 0 32 0 32 
2 0 32 0 32 
2 0 32 0 32 
4 28 28 16 16 
4 16 16 28 28 
4 4 4 16 16 
4 16 16 4 4 
01101010
15 3
17 3
15 2
16 1
17 2
15 29
17 29
15 30
16 31
17 30
29 17
29 15
30 17
31 16
30 15
3 17
3 15
2 17
1 16
2 15
01100101
1 1 9 30 0
1 1 23 30 0
1 2 10 25 0
1 2 22 25 0
1 1 2 23 0
1 1 30 23 0
1 2 7 22 0
1 3 16 22 0
1 2 25 22 0
1 5 16 21 0
1 5 16 17 0
1 3 10 16 0
1 5 11 16 0
1 3 15 16 0
1 3 17 16 0
1 5 21 16 0
1 3 22 16 0
1 5 16 15 0
1 5 16 11 0
1 2 7 10 0
1 3 16 10 0
1 2 25 10 0
1 1 2 9 0
1 1 30 9 0
1 2 10 7 0
1 2 22 7 0
1 1 8 2 0
1 1 23 2 0
2 0 16 30 2
2 2 16 28 2
2 0 2 16 4
2 2 4 16 4
2 2 28 16 3
2 0 30 16 3
2 2 16 4 1
2 0 16 2 1
01111011
5 9 30
2 23 30
8 9 24
8 23 24
2 2 23
8 8 23
8 24 23
5 30 23
6 18 19
3 13 17
6 12 14
3 20 14
5 2 9
8 8 9
8 24 9
2 30 9
8 9 8
8 23 8
2 8 2
5 23 2
7777
Głęboko w gęstym lesie, gdzie starożytne drzewa szepczą o dawnych tajemnicach, czterech młodych książąt walczy o przetrwanie i chwałę. Rozbitkowie, otoczeni zielonymi cieniami, zmierzają ku ukrytemu w sercu lasu skarbowi, gotowi stawić czoła nie tylko dzikiej naturze, ale i sobie nawzajem w desperackiej pogoni za bogactwem.