1;0;0;0;
40
40
32 32 32 56 5 5 5 5 5 5 5 5 5 5 5 5 5 48 32 32 32 32 50 5 5 5 5 5 5 5 5 5 5 5 5 5 54 32 32 32 
32 32 56 5 5 5 5 49 49 5 5 5 5 5 5 5 48 32 32 56 54 32 32 50 5 5 5 5 5 5 5 5 49 49 49 5 5 54 32 32 
32 56 5 5 5 5 51 32 32 50 5 5 5 5 5 48 32 32 56 21 23 54 32 32 50 5 5 5 5 5 5 48 32 32 32 53 5 5 54 32 
56 5 5 5 5 5 5 51 32 50 50 5 5 5 48 32 32 56 21 25 25 23 54 32 32 50 5 5 5 5 48 32 32 56 55 5 5 5 5 54 
5 5 5 5 5 5 5 54 32 32 32 50 5 5 32 32 56 21 25 25 25 25 23 54 32 32 50 5 5 54 32 32 56 5 5 5 5 49 5 5 
5 5 5 5 5 5 5 5 54 55 55 56 48 5 5 56 21 25 25 25 25 25 25 23 54 32 32 5 5 5 54 32 50 5 5 5 51 32 53 5 
5 5 49 5 5 5 5 5 5 5 5 48 32 32 5 21 25 25 25 25 30 25 25 25 23 54 5 5 50 5 5 54 32 56 5 5 48 32 50 5 
5 48 32 53 49 5 5 5 5 5 48 32 32 56 21 25 25 25 25 25 25 25 25 25 25 23 5 32 32 50 5 5 54 56 5 48 32 32 32 53 
5 51 32 49 32 50 5 5 5 48 32 32 56 21 25 25 25 25 25 25 25 25 25 25 25 25 23 54 32 32 50 5 5 5 5 54 32 54 32 56 
5 54 32 32 32 56 5 5 48 32 32 56 21 25 25 25 25 25 25 25 25 25 25 25 25 25 25 23 54 32 32 50 5 5 5 51 32 56 56 5 
5 5 54 55 56 5 5 48 32 32 56 21 25 25 25 25 10 28 25 25 25 25 25 25 10 25 25 25 23 54 32 32 50 5 5 5 55 5 5 5 
5 5 5 5 5 5 48 32 32 56 21 25 25 25 25 25 29 5 27 25 25 25 25 25 25 25 25 25 25 23 54 32 32 50 5 5 5 5 5 5 
5 5 5 5 5 48 32 32 56 21 25 25 25 25 25 29 5 50 5 27 30 25 25 25 25 25 25 25 25 25 23 54 32 32 50 5 5 5 5 5 
5 5 5 5 5 5 32 56 21 25 25 25 25 25 29 5 48 32 50 5 27 25 25 25 25 25 20 25 25 25 25 23 54 32 32 5 5 5 5 5 
5 5 5 48 32 5 5 21 25 25 25 25 25 26 5 20 51 10 32 50 5 27 25 25 25 25 25 25 25 25 25 25 23 54 5 5 50 5 5 5 
5 5 48 32 32 56 21 25 25 25 25 25 25 25 23 5 54 32 32 32 56 5 27 10 25 25 25 25 25 25 25 25 25 23 5 32 32 50 5 5 
5 48 32 32 56 21 25 25 25 30 25 25 25 25 25 23 5 54 32 32 56 5 5 24 25 25 30 25 25 28 25 25 25 25 23 54 32 32 50 5 
48 32 32 56 21 25 25 25 25 25 25 25 10 25 25 25 23 5 54 56 30 5 21 25 25 25 25 25 29 5 27 25 25 25 25 23 54 32 32 50 
32 32 56 21 25 25 25 25 25 25 25 25 25 25 25 25 25 23 5 5 5 21 25 25 25 25 25 29 5 5 5 27 25 20 25 25 23 54 32 32 
32 56 21 25 25 25 25 25 25 25 25 25 25 25 25 25 25 25 23 5 21 25 25 25 25 25 29 48 50 5 20 5 27 25 25 25 25 23 54 32 
32 50 27 25 25 25 25 10 25 25 25 25 25 30 25 25 25 25 25 22 25 25 25 25 25 26 5 54 32 50 5 5 5 24 25 25 25 29 48 32 
32 32 50 27 25 25 25 25 25 25 25 25 25 25 25 25 25 25 25 25 25 25 25 25 25 25 23 5 54 32 50 5 21 25 25 25 29 48 32 32 
54 32 32 50 27 25 25 25 25 25 20 28 25 25 25 25 25 25 25 10 29 27 25 20 25 25 25 30 5 54 56 21 25 25 25 29 48 32 32 56 
5 54 32 32 50 27 25 25 25 29 5 5 27 25 25 25 25 25 28 29 48 50 27 25 25 25 25 25 23 5 21 25 25 25 29 48 32 32 56 5 
5 5 54 32 5 5 27 25 26 5 5 50 5 27 25 25 25 26 5 48 32 32 50 27 25 25 25 25 25 22 25 25 25 29 5 32 32 56 5 5 
5 5 5 5 5 32 50 27 25 22 23 54 50 5 27 30 25 25 23 54 32 32 56 21 25 25 25 10 25 25 25 25 29 48 5 5 56 5 5 5 
5 5 5 5 54 32 32 50 27 25 25 23 54 50 5 24 25 25 25 23 54 56 21 25 25 25 25 25 25 25 25 29 48 32 32 5 5 5 5 5 
5 5 5 5 5 54 32 32 50 27 25 25 23 5 21 25 25 25 25 25 23 21 25 30 25 25 25 25 25 25 29 48 32 32 56 5 5 5 5 5 
5 5 5 5 5 5 54 32 32 50 27 25 25 22 25 25 25 25 25 25 25 25 25 25 25 25 25 25 25 29 48 32 32 56 5 5 5 5 5 5 
5 5 5 5 5 5 5 54 32 32 50 27 25 25 25 10 25 25 25 20 25 25 25 25 25 25 25 25 29 48 32 32 56 5 5 5 49 5 5 5 
5 5 48 50 5 5 5 5 54 32 32 50 27 25 25 25 25 25 25 25 25 25 25 25 25 25 25 29 48 32 32 56 5 5 5 48 32 53 5 5 
5 54 32 32 50 5 5 5 5 54 32 32 50 27 25 25 25 25 25 25 25 25 25 10 25 25 29 48 32 32 56 5 5 5 48 32 32 56 5 5 
5 5 48 32 32 50 5 5 5 5 54 32 32 5 27 25 25 25 25 25 25 25 25 25 25 29 48 32 32 56 5 5 5 48 32 32 56 5 5 5 
5 48 56 54 32 32 50 5 5 5 5 54 5 5 50 27 25 25 25 25 25 25 25 25 29 5 32 32 56 5 5 5 48 32 32 56 5 5 5 5 
5 56 5 5 54 32 53 5 5 5 5 5 5 32 32 50 27 25 25 25 25 25 25 29 48 5 5 56 5 5 5 5 5 54 56 5 5 5 5 5 
5 5 5 5 51 32 53 5 5 5 5 5 5 54 32 32 50 27 25 25 25 25 29 48 32 32 5 5 5 5 5 5 5 49 5 5 5 5 5 5 
50 5 5 5 5 55 5 5 5 48 49 50 5 5 54 32 32 50 27 25 25 29 48 32 32 56 5 5 5 5 49 5 48 32 53 5 5 5 5 48 
32 50 5 5 5 5 5 5 48 32 32 32 50 5 5 54 32 32 50 27 29 48 32 32 56 5 5 5 5 51 32 48 32 32 56 5 5 5 48 32 
32 32 50 5 5 5 5 5 5 54 54 32 32 50 5 5 54 32 32 50 48 32 32 56 5 5 5 5 5 51 32 32 32 56 5 5 5 48 32 32 
32 32 32 50 5 5 5 5 5 5 5 54 56 5 5 5 5 54 32 32 32 32 56 5 5 5 5 5 5 5 54 55 56 5 5 5 48 32 32 32 
01110000
0 0 0 0 0 0 0 0 0 0 0 0 0 0 0 0 0 0 0 0 0 0 0 0 0 0 0 0 0 0 0 0 0 0 0 0 0 0 0 0 
0 0 0 0 0 0 0 0 0 0 0 0 0 0 0 0 0 0 0 0 0 0 0 0 0 0 0 0 0 0 0 0 0 0 0 0 0 0 0 0 
0 0 0 0 0 0 0 0 0 0 0 0 0 0 0 0 0 0 0 1 1 0 0 0 0 0 0 0 0 0 0 0 0 0 0 0 0 0 0 0 
0 0 0 0 0 0 0 0 0 0 0 0 0 0 0 0 0 0 1 1 1 1 0 0 0 0 0 0 0 0 0 0 0 0 0 0 0 0 0 0 
0 0 0 0 0 0 0 0 0 0 0 0 0 0 0 0 0 1 1 1 1 1 1 0 0 0 0 0 0 0 0 0 0 0 0 0 0 0 0 0 
0 0 0 0 0 0 0 0 0 0 0 0 0 0 0 0 1 1 1 1 1 1 1 1 0 0 0 0 0 0 0 0 0 0 0 0 0 0 0 0 
0 0 0 0 0 0 0 0 0 0 0 0 0 0 0 1 1 1 1 1 2 1 1 1 1 0 0 0 0 0 0 0 0 0 0 0 0 0 0 0 
0 0 0 0 0 0 0 0 0 0 0 0 0 0 1 1 1 1 1 1 1 1 1 1 1 1 0 0 0 0 0 0 0 0 0 0 0 0 0 0 
0 0 0 0 0 0 0 0 0 0 0 0 0 1 1 1 1 1 1 1 1 1 1 1 1 1 1 0 0 0 0 0 0 0 0 0 0 0 0 0 
0 0 0 0 0 0 0 0 0 0 0 0 1 1 1 1 1 1 1 1 1 1 1 1 1 1 1 1 0 0 0 0 0 0 0 0 0 0 0 0 
0 0 0 0 0 0 0 0 0 0 0 1 1 1 1 1 2 1 1 1 1 1 1 1 2 1 1 1 1 0 0 0 0 0 0 0 0 0 0 0 
0 0 0 0 0 0 0 0 0 0 1 1 1 1 1 1 1 0 1 1 1 1 1 1 1 1 1 1 1 1 0 0 0 0 0 0 0 0 0 0 
0 0 0 0 0 0 0 0 0 1 1 1 1 1 1 1 0 0 0 1 2 1 1 1 1 1 1 1 1 1 1 0 0 0 0 0 0 0 0 0 
0 0 0 0 0 0 0 0 1 1 1 1 1 1 1 0 0 0 0 0 1 1 1 1 1 1 2 1 1 1 1 1 0 0 0 0 0 0 0 0 
0 0 0 0 0 0 0 1 1 1 1 1 1 1 0 1 0 1 0 0 0 1 1 1 1 1 1 1 1 1 1 1 1 0 0 0 0 0 0 0 
0 0 0 0 0 0 1 1 1 1 1 1 1 1 1 0 0 0 0 0 0 0 1 2 1 1 1 1 1 1 1 1 1 1 0 0 0 0 0 0 
0 0 0 0 0 1 1 1 1 2 1 1 1 1 1 1 0 0 0 0 0 0 0 1 1 1 2 1 1 1 1 1 1 1 1 0 0 0 0 0 
0 0 0 0 1 1 1 1 1 1 1 1 2 1 1 1 1 0 0 0 1 0 1 1 1 1 1 1 1 0 1 1 1 1 1 1 0 0 0 0 
0 0 0 1 1 1 1 1 1 1 1 1 1 1 1 1 1 1 0 0 0 1 1 1 1 1 1 1 0 0 0 1 1 2 1 1 1 0 0 0 
0 0 1 1 1 1 1 1 1 1 1 1 1 1 1 1 1 1 1 0 1 1 1 1 1 1 1 0 0 0 2 0 1 1 1 1 1 1 0 0 
0 0 1 1 1 1 1 2 1 1 1 1 1 2 1 1 1 1 1 1 1 1 1 1 1 1 0 0 0 0 0 0 0 1 1 1 1 1 0 0 
0 0 0 1 1 1 1 1 1 1 1 1 1 1 1 1 1 1 1 1 1 1 1 1 1 1 1 0 0 0 0 0 1 1 1 1 1 0 0 0 
0 0 0 0 1 1 1 1 1 1 2 1 1 1 1 1 1 1 1 2 1 1 1 2 1 1 1 2 0 0 0 1 1 1 1 1 0 0 0 0 
0 0 0 0 0 1 1 1 1 1 0 0 1 1 1 1 1 1 1 1 0 0 1 1 1 1 1 1 1 0 1 1 1 1 1 0 0 0 0 0 
0 0 0 0 0 0 1 1 1 0 0 0 0 1 1 1 1 1 0 0 0 0 0 1 1 1 1 1 1 1 1 1 1 1 0 0 0 0 0 1 
0 0 0 0 0 0 0 1 1 1 1 0 0 0 1 2 1 1 1 0 0 0 0 1 1 1 1 2 1 1 1 1 1 0 0 0 0 0 0 0 
0 0 0 0 0 0 0 0 1 1 1 1 0 0 0 1 1 1 1 1 0 0 1 1 1 1 1 1 1 1 1 1 0 0 0 0 0 0 0 0 
0 0 0 0 0 0 0 0 0 1 1 1 1 0 1 1 1 1 1 1 1 1 1 2 1 1 1 1 1 1 1 0 0 0 0 0 0 0 0 0 
0 0 0 0 0 0 0 0 0 0 1 1 1 1 1 1 1 1 1 1 1 1 1 1 1 1 1 1 1 1 0 0 0 0 0 0 0 0 0 0 
0 0 0 0 0 0 0 0 0 0 0 1 1 1 1 2 1 1 1 2 1 1 1 1 1 1 1 1 1 0 0 0 0 0 0 0 0 0 0 0 
0 0 0 0 0 0 0 0 0 0 0 0 1 1 1 1 1 1 1 1 1 1 1 1 1 1 1 1 0 0 0 0 0 0 0 0 0 0 0 0 
0 0 0 0 0 0 0 0 0 0 0 0 0 1 1 1 1 1 1 1 1 1 1 2 1 1 1 0 0 0 0 0 0 0 0 0 0 0 0 0 
0 0 0 0 0 0 0 0 0 0 0 0 0 0 1 1 1 1 1 1 1 1 1 1 1 1 0 0 0 0 0 0 0 0 0 0 0 0 0 0 
0 0 0 0 0 0 0 0 0 0 0 0 0 0 0 1 1 1 1 1 1 1 1 1 1 0 0 0 0 0 0 0 0 0 0 0 0 0 0 0 
0 0 0 0 0 0 0 0 0 0 0 0 0 0 0 0 1 1 1 1 1 1 1 1 0 0 0 0 0 0 0 0 0 0 0 0 0 0 0 0 
0 0 0 0 0 0 0 0 0 0 0 0 0 0 0 0 0 1 1 1 1 1 1 0 0 0 0 0 0 0 0 0 0 0 0 0 0 0 0 0 
0 0 0 0 0 0 0 0 0 0 0 0 0 0 0 0 0 0 1 1 1 1 0 0 0 0 0 0 0 0 0 0 0 0 0 0 0 0 0 0 
0 0 0 0 0 0 0 0 0 0 0 0 0 0 0 0 0 0 0 1 1 0 0 0 0 0 0 0 0 0 0 0 0 0 0 0 0 0 0 0 
0 0 0 0 0 0 0 0 0 0 0 0 0 0 0 0 0 0 0 0 0 0 0 0 0 0 0 0 0 0 0 0 0 0 0 0 0 0 0 0 
0 0 0 0 0 0 0 0 0 0 0 0 0 0 0 0 0 0 0 0 0 0 0 0 0 0 0 0 0 0 0 0 0 0 0 0 0 0 0 0 
01111010
4 9 9 0 0 
4 9 9 33 33 
4 35 35 38 38 
4 37 37 7 7 
4 2 37 19 20 
4 2 37 19 20 
4 19 20 2 37 
4 19 20 2 37 
4 19 20 2 37 
4 19 20 2 37 
01101010
1 35
5 38
12 38
1 28
6 33
36 36
29 37
37 28
31 32
34 34
37 4
28 3
37 13
32 9
38 8
4 1
12 3
4 10
1 12
2 4
01100101
1 4 29 39 0
1 4 34 39 0
1 4 15 38 0
1 4 2 37 0
1 1 6 36 0
1 2 21 36 0
1 1 20 35 0
1 2 21 35 0
1 5 18 34 0
1 1 29 34 0
1 6 20 33 0
1 2 17 32 0
1 2 23 32 0
1 4 8 31 0
1 3 19 31 0
1 5 21 31 0
1 1 0 30 0
1 5 14 30 0
1 5 26 30 0
1 5 18 29 0
1 2 20 29 0
1 2 21 29 0
1 1 37 29 0
1 4 39 29 0
1 1 5 28 0
1 3 13 28 0
1 5 23 28 0
1 2 27 28 0
1 2 11 27 0
1 5 13 27 0
1 6 20 27 0
1 2 25 27 0
1 5 23 26 0
1 5 28 26 0
1 4 1 25 0
1 5 10 25 0
1 4 37 25 0
1 5 7 24 0
1 2 12 24 0
1 5 31 24 0
1 1 38 24 0
1 4 39 24 0
1 2 14 23 0
1 3 24 23 0
1 6 26 23 0
1 2 29 23 0
1 2 32 23 0
1 6 20 22 0
1 2 5 21 0
1 5 7 21 0
1 2 11 21 0
1 5 14 21 0
1 2 19 21 0
1 2 23 21 0
1 5 25 21 0
1 5 16 20 0
1 5 22 20 0
1 5 35 20 0
1 2 37 20 0
1 5 10 19 0
1 2 21 19 0
1 2 24 19 0
1 2 5 18 0
1 5 16 18 0
1 2 25 18 0
1 2 14 17 0
1 6 27 17 0
1 5 34 17 0
1 2 6 16 0
1 5 8 16 0
1 3 14 16 0
1 2 17 16 0
1 2 32 16 0
1 1 0 15 0
1 5 25 15 0
1 1 39 15 0
1 6 15 14 0
1 5 30 14 0
1 2 25 13 0
1 3 29 13 0
1 4 38 13 0
1 4 4 12 0
1 2 10 12 0
1 2 16 12 0
1 1 23 12 0
1 2 28 12 0
1 5 25 11 0
1 5 27 11 0
1 2 13 10 0
1 2 17 10 0
1 3 22 10 0
1 2 26 10 0
1 2 21 9 0
1 1 8 8 0
1 5 15 8 0
1 4 1 7 0
1 2 17 7 0
1 5 20 7 0
1 4 30 7 0
1 4 39 7 0
1 5 20 6 0
1 2 22 6 0
1 4 7 4 0
1 5 18 4 0
1 5 20 3 0
1 4 36 3 0
1 1 25 2 0
1 1 5 1 0
1 1 36 1 0
1 4 6 0 0
2 2 35 38 2
2 5 33 35 2
2 5 3 33 1
2 2 9 33 1
2 2 37 7 3
2 5 2 5 4
2 5 34 4 3
2 2 9 0 4
01111011
4 7 39
1 11 39
4 24 39
5 29 39
5 34 39
1 4 38
1 14 38
5 15 38
1 30 38
5 2 37
4 11 37
1 25 37
4 27 37
1 36 37
2 6 36
4 38 36
7 2 35
3 21 35
7 27 35
7 36 35
1 0 34
1 7 34
6 18 34
2 29 34
4 34 34
1 39 34
4 5 33
4 0 32
3 17 32
3 23 32
1 7 31
5 8 31
8 19 31
6 21 31
1 31 31
2 0 30
6 14 30
6 26 30
4 33 30
7 6 29
6 18 29
3 20 29
3 21 29
2 37 29
5 39 29
7 0 28
2 5 28
8 13 28
6 23 28
3 27 28
1 35 28
4 38 28
1 0 27
4 2 27
3 11 27
6 13 27
3 25 27
7 38 27
6 23 26
6 28 26
1 39 26
5 1 25
6 10 25
5 37 25
6 7 24
3 12 24
6 31 24
2 38 24
3 14 23
8 24 23
3 29 23
3 32 23
3 5 21
6 7 21
3 11 21
6 14 21
3 19 21
3 23 21
6 25 21
6 16 20
6 22 20
6 35 20
6 10 19
3 21 19
3 24 19
3 5 18
6 16 18
3 25 18
3 14 17
6 34 17
3 6 16
6 8 16
8 14 16
3 17 16
3 32 16
2 0 15
6 25 15
2 39 15
6 30 14
1 2 13
3 25 13
8 29 13
5 38 13
1 39 13
4 0 12
7 3 12
5 4 12
3 10 12
3 16 12
3 28 12
1 36 12
6 25 11
6 27 11
4 39 11
1 0 10
4 5 10
3 13 10
3 17 10
8 22 10
3 26 10
4 34 10
7 0 9
3 21 9
1 32 9
1 7 8
2 8 8
6 15 8
1 39 8
5 1 7
7 8 7
3 17 7
6 20 7
5 30 7
7 32 7
5 39 7
6 20 6
3 22 6
7 39 6
4 9 5
1 11 5
4 29 5
4 37 5
4 1 4
5 7 4
6 18 4
1 31 4
1 3 3
6 20 3
1 27 3
5 36 3
2 25 2
7 26 2
2 5 1
1 7 1
1 14 1
4 26 1
2 36 1
1 4 0
5 6 0
4 14 0
1 24 0
7777
