1;0;0;0;
20
20
0
5 5 5 50 5 5 5 5 5 5 5 5 54 32 32 32 32 32 32 32 
5 5 51 32 50 5 5 5 5 5 5 5 5 54 56 54 32 32 32 32 
5 5 51 32 32 50 5 5 5 5 5 5 5 5 5 5 54 32 32 32 
5 5 51 32 32 32 50 5 48 50 5 5 5 5 5 5 5 54 32 32 
5 5 5 55 55 55 5 54 32 32 50 50 5 48 50 5 5 5 54 56 
5 5 5 5 5 5 5 5 54 32 32 32 50 32 32 50 5 5 5 5 
5 5 5 5 5 5 5 5 5 54 32 32 32 32 32 32 50 5 5 5 
5 5 5 5 50 5 5 5 5 54 32 32 32 32 32 32 5 5 5 5 
5 5 5 5 32 50 5 5 5 5 54 54 32 32 32 5 5 5 5 5 
5 5 5 5 32 32 50 5 5 5 5 5 54 32 32 50 5 5 5 5 
5 5 5 5 32 32 32 50 5 5 5 5 54 32 32 32 50 5 5 5 
5 5 5 54 32 32 32 32 50 5 5 5 5 54 32 32 50 50 5 5 
5 5 5 5 54 32 32 32 32 50 5 5 5 54 32 32 32 50 5 5 
5 5 5 5 5 54 32 32 32 32 50 5 5 54 55 55 55 5 5 5 
50 50 5 5 5 5 5 5 5 5 5 5 5 5 48 50 5 5 5 5 
32 32 53 5 5 5 5 5 5 5 5 5 5 48 32 32 53 5 5 5 
32 32 48 50 5 5 5 5 5 5 5 5 5 54 32 32 53 5 5 5 
32 32 32 32 50 50 5 5 5 5 5 5 5 5 54 32 56 5 5 5 
32 32 32 32 32 32 50 50 5 5 5 5 5 5 54 56 5 5 5 5 
32 32 32 32 32 32 32 32 50 5 5 5 5 5 5 5 5 5 5 5 
01110000
0 0 0 0 0 0 0 0 0 0 0 0 0 0 0 0 0 0 0 0 
0 0 0 0 0 0 0 0 0 0 0 0 0 0 0 0 0 0 0 0 
0 0 0 0 0 0 0 0 0 0 0 0 0 0 0 0 0 0 0 0 
0 0 0 0 0 0 0 0 0 0 0 0 0 0 0 0 0 0 0 0 
0 0 0 0 0 0 0 0 0 0 0 0 0 0 0 0 0 0 0 0 
0 0 0 0 0 0 0 0 0 0 0 0 0 0 0 0 0 0 0 0 
0 0 0 0 0 0 0 0 0 0 0 0 0 0 0 0 0 0 0 0 
0 0 0 0 0 0 0 0 0 0 0 0 0 0 0 0 0 0 0 0 
0 0 0 0 0 0 0 0 0 0 0 0 0 0 0 0 0 0 0 0 
0 0 0 0 0 0 0 0 0 0 0 0 0 0 0 0 0 0 0 0 
0 0 0 0 0 0 0 0 0 0 0 0 0 0 0 0 0 0 0 0 
0 0 0 0 0 0 0 0 0 0 0 0 0 0 0 0 0 0 0 0 
0 0 0 0 0 0 0 0 0 0 0 0 0 0 0 0 0 0 0 0 
0 0 0 0 0 0 0 0 0 0 0 0 0 0 0 0 0 0 0 0 
0 0 0 0 0 0 0 0 0 0 0 0 0 0 0 0 0 0 0 0 
0 0 0 0 0 0 0 0 0 0 0 0 0 0 0 0 0 0 0 0 
0 0 0 0 0 0 0 0 0 0 0 0 0 0 0 0 0 0 0 0 
0 0 0 0 0 0 0 0 0 0 0 0 0 0 0 0 0 0 0 0 
0 0 0 0 0 0 0 0 0 0 0 0 0 0 0 0 0 0 0 0 
0 0 0 0 0 0 0 0 0 0 0 0 0 0 0 0 0 0 0 0 
01111010
6 19 19 0 0 
6 0 0 19 19 
8 0 19 0 19 
01101010
1 15
0 17
0 18
5 19
6 18
18 2
17 0
19 4
15 0
17 5
01100101
1 1 13 17 0
1 6 18 17 0
1 5 16 15 0
1 6 13 13 0
1 1 7 12 0
1 1 18 12 0
1 5 9 10 0
1 1 1 9 0
1 6 6 8 0
1 1 11 7 0
1 5 2 6 0
1 1 6 4 0
1 6 3 2 0
2 2 0 19 1
2 5 1 17 1
2 5 17 3 2
2 2 19 0 2
01111011
2 10 18
2 12 18
2 9 17
5 11 17
2 14 17
8 11 16
2 12 16
5 13 16
2 14 16
2 16 16
2 12 15
5 16 15
2 17 15
2 16 14
2 18 14
2 6 13
5 17 13
8 18 13
2 19 13
8 5 12
5 8 12
8 16 12
2 17 12
2 18 12
2 1 11
2 2 11
5 16 11
5 0 10
2 7 10
5 8 10
2 9 10
5 10 10
2 19 10
5 2 9
8 9 9
2 11 9
2 17 9
8 18 9
2 1 8
8 2 8
2 10 8
2 12 8
5 0 7
5 1 7
2 2 6
5 4 6
2 11 6
2 3 5
2 4 5
5 6 5
8 12 5
8 4 4
2 7 4
5 10 4
5 5 3
5 7 2
2 9 2
7777
Trawa jest zawsze bardziej zielona po drugiej stronie płotu. 
Dlaczego więc nie zdobyć tej zieleńszej trawy siłą?
Pora pokazać sąsiadowi kto na prawde jest silniejszy i zdobyć
jego połać terenu. 