1;8;0;13,13,45;
25
25
0
10 55 55 32 32 32 50 5 7 38 27 25 20 25 29 39 19 5 48 32 32 32 55 55 10 
53 5 5 54 32 32 32 50 5 7 38 27 28 29 39 9 5 48 32 32 32 56 5 5 51 
53 5 5 5 54 32 32 53 5 5 17 38 5 39 19 5 5 51 32 32 56 5 5 5 51 
32 50 5 5 5 54 32 53 5 5 5 17 8 9 5 5 5 51 32 56 5 5 5 48 32 
32 32 50 5 5 5 54 56 5 5 5 5 5 5 5 5 5 54 56 5 5 5 48 32 32 
32 32 32 50 5 5 5 5 5 5 48 50 5 48 50 5 5 5 5 5 5 48 32 32 32 
54 32 32 32 50 5 5 5 5 48 32 56 5 54 32 50 5 5 5 5 48 32 32 32 56 
5 54 55 55 56 5 5 5 48 32 56 5 5 5 54 32 50 5 5 5 54 55 55 56 5 
13 5 5 5 5 5 5 48 32 56 11 12 12 3 5 54 32 50 5 5 5 5 5 5 11 
37 3 5 5 5 5 48 32 56 5 14 5 5 6 5 5 54 32 50 5 5 5 5 11 36 
23 37 13 5 5 48 32 56 5 5 45 8 38 37 42 3 5 54 32 50 5 5 1 36 21 
25 23 37 3 5 54 56 5 5 11 36 11 36 39 19 16 5 5 54 56 5 1 36 21 25 
20 26 5 16 5 5 5 5 5 14 5 14 30 16 39 9 5 5 5 5 5 4 5 24 20 
25 29 39 9 5 48 50 5 5 17 38 17 18 9 16 5 5 5 48 50 5 17 38 27 25 
29 39 9 5 5 54 32 50 5 5 7 5 5 39 19 5 5 48 32 56 5 5 7 38 27 
39 19 5 5 5 5 54 32 50 5 5 7 18 19 5 5 48 32 56 5 5 5 5 17 38 
19 5 5 5 5 5 5 54 32 50 5 5 5 5 5 48 32 56 5 5 5 5 5 5 7 
5 48 49 49 50 5 5 5 54 32 50 5 5 5 48 32 56 5 5 5 48 49 49 50 5 
48 32 32 32 56 5 5 5 5 54 32 50 5 48 32 56 5 5 5 5 54 32 32 32 50 
32 32 32 56 5 5 5 5 5 5 54 56 5 54 56 5 5 5 5 5 5 54 32 32 32 
32 32 56 5 5 5 48 50 5 5 5 5 5 5 5 5 5 48 50 5 5 5 54 32 32 
32 56 5 5 5 48 32 53 5 5 5 1 12 13 5 5 5 51 32 50 5 5 5 54 32 
53 5 5 5 48 32 32 53 5 5 11 36 5 37 3 5 5 51 32 32 50 5 5 5 51 
53 5 5 48 32 32 32 56 5 1 36 21 22 23 37 13 5 54 32 32 32 50 5 5 51 
10 49 49 32 32 32 56 5 11 36 21 25 20 25 23 37 3 5 54 32 32 32 49 49 10 
01110000
0 0 0 2 2 2 1 0 1 2 3 4 5 4 3 2 1 0 1 2 2 2 0 0 0 
0 0 0 1 2 2 2 1 0 1 2 3 3 3 2 1 0 1 2 2 0 1 0 0 0 
0 0 0 0 1 2 2 1 0 0 1 2 2 2 1 0 0 1 2 2 1 0 0 0 0 
2 1 0 0 0 1 2 1 0 0 0 1 1 1 0 0 0 1 2 1 0 0 0 1 2 
2 2 1 0 0 0 1 1 0 0 0 0 0 0 0 0 0 1 1 0 0 0 1 2 2 
2 2 2 1 0 0 0 0 0 0 1 1 0 1 1 0 0 0 0 0 0 1 2 2 2 
1 2 2 2 1 0 0 0 0 1 2 1 0 1 2 1 0 0 0 0 1 2 2 2 1 
0 1 1 1 1 0 0 0 1 2 1 0 0 0 1 2 1 0 0 0 1 1 1 1 0 
1 0 0 0 0 0 0 1 2 1 3 3 1 3 0 1 2 1 0 0 0 0 0 0 1 
2 1 0 0 0 0 1 2 1 0 3 3 2 3 0 0 1 2 1 0 0 0 0 1 2 
3 2 1 0 0 1 2 1 0 0 3 3 2 3 3 2 0 1 2 1 0 0 1 2 3 
4 3 2 1 0 1 1 0 0 2 2 3 3 3 3 1 0 0 1 1 0 1 2 3 4 
5 3 2 1 0 0 0 0 0 1 2 3 4 3 2 2 0 0 0 0 0 1 2 3 5 
4 3 2 1 0 1 1 0 0 2 2 3 3 3 2 0 0 0 1 1 0 1 2 3 4 
3 2 1 0 0 1 2 1 0 0 2 2 2 2 2 0 0 1 2 1 0 0 1 2 3 
2 1 0 0 0 0 1 2 1 0 0 2 1 2 0 0 1 2 1 0 0 0 0 1 2 
1 0 0 0 0 0 0 1 2 1 0 0 0 0 0 1 2 1 0 0 0 0 0 0 1 
0 1 1 1 1 0 0 0 1 2 1 0 0 0 1 2 1 0 0 0 1 1 1 1 0 
1 2 2 2 1 0 0 0 0 1 2 1 0 1 2 1 0 0 0 0 1 2 2 2 1 
2 2 2 1 0 0 0 0 0 0 1 1 0 1 1 0 0 0 0 0 0 1 2 2 2 
2 2 1 0 0 0 1 1 0 0 0 0 0 0 0 0 0 1 1 0 0 0 1 2 2 
2 1 0 0 0 1 2 1 0 0 0 1 1 1 0 0 0 1 2 1 0 0 0 1 2 
0 0 0 0 1 2 2 1 0 0 1 2 2 2 1 0 0 1 2 2 1 0 0 0 0 
0 0 0 1 2 2 2 1 0 1 2 3 3 3 2 1 0 1 2 2 2 1 0 0 0 
0 0 0 2 2 2 1 0 1 2 3 4 5 4 3 2 1 0 1 2 2 2 0 0 0 
01111010
4 7 7 7 7 
4 7 7 17 17 
4 17 17 7 7 
4 17 17 17 17 
4 6 17 6 17 
4 6 17 6 17 
4 6 17 6 17 
4 6 17 6 17 
2 6 17 6 17 
01101010
1 23
2 23
1 22
2 22
5 19
23 23
22 23
22 22
23 22
19 19
22 1
22 2
23 1
23 2
19 5
1 1
2 1
1 2
2 2
5 5
01100101
1 6 11 24 0
1 6 13 24 0
1 4 7 22 0
1 4 17 22 0
1 3 9 20 0
1 3 15 20 0
1 1 18 20 0
1 1 3 19 0
1 5 9 18 0
1 4 2 17 0
1 2 12 17 0
1 5 14 17 0
1 4 22 17 0
1 6 9 16 0
1 5 12 16 0
1 3 4 15 0
1 5 8 15 0
1 6 16 15 0
1 5 18 15 0
1 3 20 15 0
1 6 0 13 0
1 5 15 13 0
1 2 16 13 0
1 6 24 13 0
1 2 8 12 0
1 5 9 12 0
1 5 12 12 0
1 6 0 11 0
1 6 24 11 0
1 5 7 10 0
1 3 4 9 0
1 5 12 9 0
1 6 16 9 0
1 5 18 9 0
1 3 20 9 0
1 6 9 8 0
1 2 12 8 0
1 4 2 7 0
1 5 14 7 0
1 4 22 7 0
1 5 9 6 0
1 1 21 5 0
1 1 6 4 0
1 3 9 4 0
1 3 15 4 0
1 4 7 2 0
1 4 17 2 0
1 6 11 0 0
1 6 13 0 0
2 5 3 21 1
2 5 21 21 2
2 4 5 20 1
2 9 8 20 1
2 7 11 20 1
2 7 13 20 2
2 9 16 20 2
2 4 19 20 2
2 3 4 19 1
2 9 8 19 1
2 9 16 19 2
2 3 20 19 2
2 7 6 18 1
2 9 8 18 1
2 9 16 18 2
2 7 18 18 2
2 2 7 17 1
2 9 8 17 1
2 9 16 17 2
2 2 17 17 2
2 9 4 16 1
2 9 5 16 1
2 9 6 16 1
2 9 7 16 1
2 9 17 16 2
2 9 18 16 2
2 9 19 16 2
2 9 20 16 2
2 7 4 13 1
2 7 20 13 2
2 7 4 11 4
2 7 20 11 3
2 9 4 8 4
2 9 5 8 4
2 9 6 8 4
2 9 7 8 4
2 9 18 8 3
2 9 19 8 3
2 9 20 8 3
2 9 21 8 3
2 2 7 7 4
2 9 8 7 4
2 9 16 7 3
2 2 17 7 3
2 7 6 6 4
2 9 8 6 4
2 9 16 6 3
2 7 18 6 3
2 4 4 5 4
2 9 8 5 4
2 9 16 5 3
2 4 20 5 3
2 3 5 4 4
2 9 8 4 4
2 7 11 4 4
2 7 13 4 3
2 9 16 4 3
2 3 19 4 3
2 5 3 3 4
2 5 21 3 3
01111011
4 2 24
7 7 24
8 11 24
8 13 24
7 17 24
4 22 24
4 0 22
1 4 22
5 7 22
5 17 22
1 20 22
4 24 22
1 2 20
2 9 20
2 15 20
1 18 20
1 3 19
1 21 19
2 9 18
3 12 18
7 0 17
5 2 17
2 14 17
5 22 17
7 24 17
6 9 16
3 12 16
2 4 15
2 8 15
6 16 15
2 18 15
2 20 15
8 0 13
3 15 13
8 24 13
3 6 12
3 9 12
3 18 12
8 0 11
8 24 11
2 7 10
2 4 9
3 12 9
6 16 9
2 18 9
2 20 9
6 9 8
7 0 7
5 2 7
2 14 7
5 22 7
7 24 7
2 9 6
3 12 6
1 21 5
1 2 4
1 6 4
2 9 4
2 15 4
1 18 4
4 0 2
1 4 2
5 7 2
5 17 2
1 20 2
4 24 2
4 2 0
7 7 0
8 11 0
8 13 0
7 17 0
4 22 0
7777
Wojna trwa, wielu poniosło straty, a obozy zostały wzniesiony
w każdej chwili może rozpocząć się ostateczne natarcie, lecz
czy świat jest na to gotowy?