1;0;0;0;
19
33
0
32 32 32 32 32 32 32 56 0 0 0 54 32 32 32 32 32 32 32
32 32 32 32 32 32 56 5 5 5 5 5 54 32 32 32 32 32 32 32
32 32 32 32 32 32 0 5 5 5 5 5 0 32 32 32 32 32 32 32
32 32 32 32 32 32 0 5 5 5 5 10 0 32 32 32 32 32 32 32
32 32 32 32 32 32 0 5 5 5 5 5 0 32 32 32 32 32 32 32
32 32 32 32 32 32 0 5 5 5 5 5 0 32 32 32 32 32 32 32
32 32 32 5 5 5 5 5 5 5 5 5 5 32 32 32 32 32 32 32
32 32 32 5 5 5 5 5 5 5 5 5 5 32 32 32 32 32 32 32
32 32 32 32 32 5 5 5 5 11 12 12 12 32 32 32 32 32 32 32
32 32 32 32 32 5 5 5 5 14 5 20 5 54 32 32 32 32 32 32
32 32 32 56 5 5 5 5 5 14 5 5 5 0 32 32 32 32 32 32
32 32 56 5 5 5 5 5 5 5 5 5 5 0 32 32 32 32 32 32
32 56 5 5 5 5 5 5 5 5 5 5 5 0 32 32 32 32 32 32
56 5 5 5 5 5 5 5 5 14 5 5 5 0 32 32 32 32 32 32
50 5 20 5 16 5 5 5 5 17 18 38 5 48 32 32 32 32 32 32
32 18 18 38 16 5 5 5 32 32 32 17 18 32 32 32 32 32 32 32
32 32 32 17 19 5 5 5 5 11 13 32 32 32 32 32 32 32 32 32
32 12 13 32 32 32 5 5 5 14 37 12 12 32 32 32 32 32 32 32
56 5 37 12 13 5 5 5 5 14 5 20 5 54 32 32 32 32 32 32
0 5 5 5 16 5 5 5 5 5 5 5 5 48 32 32 32 32 32 32
0 5 5 5 5 5 5 5 5 5 5 5 48 32 32 32 32 32 32 32
0 5 5 5 5 5 5 5 5 5 5 48 32 32 32 32 32 32 32 32
0 5 5 5 16 5 5 5 5 5 48 32 32 32 32 32 32 32 32 32
50 5 20 5 16 5 5 5 5 32 32 32 32 32 32 32 32 32 32 32
32 18 18 18 19 5 5 5 5 32 32 32 32 32 32 32 32 32 32 32
32 5 5 5 5 5 5 5 5 5 5 32 32 32 32 32 32 32 32 32
32 5 5 5 5 5 5 5 5 5 5 32 32 32 32 32 32 32 32 32
32 0 5 5 5 5 5 0 32 32 32 32 32 32 32 32 32 32 32 32
32 0 5 5 5 5 5 0 32 32 32 32 32 32 32 32 32 32 32 32
32 0 10 5 5 5 5 0 32 32 32 32 32 32 32 32 32 32 32 32
32 0 5 5 5 5 5 0 32 32 32 32 32 32 32 32 32 32 32 32
32 50 5 5 5 5 5 48 32 32 32 32 32 32 32 32 32 32 32 32
32 32 50 0 0 0 48 32 32 32 32 32 32 32 32 32 32 32 32 32
01110000
0 0 0 0 0 0 0 0 0 0 0 0 0 0 0 0 0 0 0
0 0 0 0 0 0 0 0 0 0 0 0 0 0 0 0 0 0 0
0 0 0 0 0 0 0 0 0 0 0 0 0 0 0 0 0 0 0
0 0 0 0 0 0 0 0 0 0 0 0 0 0 0 0 0 0 0
0 0 0 0 0 0 0 0 0 0 0 0 0 0 0 0 0 0 0
0 0 0 0 0 0 0 0 0 0 0 0 0 0 0 0 0 0 0
0 0 0 0 0 0 0 0 0 0 0 0 0 0 0 0 0 0 0
0 0 0 0 0 0 0 0 0 0 0 0 0 0 0 0 0 0 0
0 0 0 0 0 0 0 0 0 2 2 2 2 0 0 0 0 0 0
0 0 0 0 0 0 0 0 0 2 2 2 2 2 0 0 0 0 0
0 0 0 1 1 0 0 0 0 2 2 2 2 2 0 0 0 0 0
0 0 2 2 1 0 0 0 0 1 2 2 2 2 0 0 0 0 0
0 2 2 2 1 0 0 0 0 1 2 2 2 2 0 0 0 0 0
2 2 2 2 1 0 0 0 0 2 2 2 2 2 0 0 0 0 0
2 2 2 2 2 0 0 0 0 2 2 2 2 2 0 0 0 0 0
0 2 2 2 2 0 0 0 0 0 0 2 2 0 0 0 0 0 0
0 0 0 2 2 0 0 0 0 2 2 0 0 0 0 0 0 0 0
0 2 2 0 0 0 0 0 0 2 2 2 2 0 0 0 0 0 0
2 2 2 2 2 0 0 0 0 2 2 2 2 2 0 0 0 0 0
2 2 2 2 2 0 0 0 0 1 2 2 2 2 0 0 0 0 0
2 2 2 2 1 0 0 0 0 1 2 2 2 0 0 0 0 0 0
2 2 2 2 1 0 0 0 0 1 2 2 0 0 0 0 0 0 0
2 2 2 2 2 0 0 0 0 1 1 0 0 0 0 0 0 0 0
2 2 2 2 2 0 0 0 0 0 0 0 0 0 0 0 0 0 0
0 2 2 2 2 0 0 0 0 0 0 0 0 0 0 0 0 0 0
0 0 0 0 0 0 0 0 0 0 0 0 0 0 0 0 0 0 0
0 0 0 0 0 0 0 0 0 0 0 0 0 0 0 0 0 0 0
0 0 0 0 0 0 0 0 0 0 0 0 0 0 0 0 0 0 0
0 0 0 0 0 0 0 0 0 0 0 0 0 0 0 0 0 0 0
0 0 0 0 0 0 0 0 0 0 0 0 0 0 0 0 0 0 0
0 0 0 0 0 0 0 0 0 0 0 0 0 0 0 0 0 0 0
0 0 0 0 0 0 0 0 0 0 0 0 0 0 0 0 0 0 0
0 0 0 0 0 0 0 0 0 0 0 0 0 0 0 0 0 0 0
01111010
4 4 4 3 3 
4 9 9 29 29 
4 2 4 17 20 
4 9 12 18 25 
4 9 12 12 15 
4 1 4 8 14 
01101010
3 2
5 2
4 4
3 4
5 4
10 30
8 30
9 28
10 28
8 28
01100101
1 1 3 26 0
1 1 3 25 0
1 1 12 25 0
1 1 5 23 0
1 2 10 21 0
1 2 10 20 0
1 4 2 19 0
1 6 1 18 0
1 3 6 16 0
1 1 7 16 0
1 6 12 14 0
1 4 11 13 0
1 2 3 12 0
1 2 3 11 0
1 1 8 9 0
1 1 1 7 0
1 1 10 7 0
1 1 10 6 0
2 5 9 30 2
2 2 9 29 2
2 2 4 3 1
2 5 4 2 1
01111011
1 3 26
1 12 26
4 3 25
4 12 25
7 1 19
1 12 18
1 1 14
7 12 13
4 1 7
4 10 7
1 1 6
1 10 6
7777
Pośrodku starożytnej doliny, gdzie góry wyrastają jak ciche strażnicy dawnych tajemnic, dwaj bracia przygotowują się do ostatecznej bitwy. Ziemia drży pod ich stopami, gdy zbliżają się do siebie, każdy na swojej stronie mrocznego pasma, gotowi stawić czoła własnej krwi w walce o dominację.