0;3;2;0;
12
10
30 0 32 56 0 5 5 5 32 32 32 30 
32 32 56 0 0 5 5 5 10 5 32 32 
32 56 5 5 5 1 3 5 5 20 5 32 
5 5 5 5 5 7 9 5 5 5 30 32 
5 5 5 5 5 5 30 5 5 5 5 32 
5 5 5 5 5 21 23 5 5 5 5 11 
25 5 5 5 5 27 29 5 5 5 5 14 
25 5 5 5 5 5 5 5 5 5 5 14 
25 25 5 5 5 5 5 5 5 5 11 36 
30 25 25 5 5 5 5 5 5 11 36 30 
01110000
0 0 0 0 0 0 0 0 0 0 0 0 
0 0 0 0 0 0 0 0 0 0 0 0 
0 0 0 0 0 0 0 0 0 0 0 0 
0 0 0 0 0 0 0 0 0 0 0 0 
0 0 0 0 0 0 0 0 0 0 0 0 
0 0 0 0 0 1 1 0 0 0 0 2 
9 0 0 0 0 1 1 0 0 0 0 2 
9 0 0 0 0 0 0 0 0 0 0 2 
9 9 0 0 0 0 0 0 0 0 2 2 
9 9 9 0 0 0 0 0 0 2 2 2 
01111010
4 1 1 4 4 
4 1 4 4 6 
01101010
8 0
9 1
10 2
9 2
8 1
5 9
6 9
7 9
5 8
6 8
01100101
1 1 7 7 0
1 2 7 6 0
1 1 8 6 0
2 5 2 7 2
2 2 3 7 2
2 5 0 4 1
2 2 1 4 1
2 9 4 4 1
2 9 4 3 1
2 9 3 2 1
2 9 2 1 1
01111011
8 9 8
6 8 7
8 10 7
6 9 6
3 8 5
3 9 5
7777
