1;8;0;15,15,50;
30
30
0
5 5 54 32 32 53 7 38 5 5 5 5 5 5 5 5 48 49 50 5 5 5 39 19 51 32 32 56 5 5 
5 5 5 54 32 53 5 7 38 5 5 5 5 5 21 23 54 32 56 5 5 39 9 5 51 32 56 5 5 5 
50 5 5 5 54 53 5 5 7 38 5 5 5 21 25 25 23 55 56 5 39 19 5 5 51 56 5 5 5 48 
32 50 5 5 5 5 5 5 5 17 38 5 21 25 25 25 25 23 5 39 9 5 5 5 5 5 5 5 48 32 
32 32 50 5 5 5 48 50 5 5 7 38 27 25 20 25 25 29 39 19 5 48 50 5 5 5 5 48 32 32 
55 55 55 5 5 5 54 32 50 5 5 7 38 27 25 25 29 39 19 5 5 54 32 50 5 5 5 55 55 55 
13 5 5 5 5 5 5 54 32 50 5 5 17 38 27 29 39 19 5 5 5 5 48 32 50 5 5 5 5 1 
37 3 5 5 5 5 51 32 56 5 5 5 5 17 8 8 19 5 5 5 5 48 32 56 5 5 5 5 11 36 
5 37 13 5 5 5 51 32 53 5 5 5 5 5 5 5 5 5 5 5 48 32 56 5 5 5 5 1 36 5 
5 5 37 3 5 5 5 56 5 5 5 5 48 49 50 5 48 50 5 48 32 56 5 5 5 5 11 36 5 5 
5 5 5 37 13 5 5 5 5 5 5 48 32 32 53 51 32 32 50 54 56 5 5 5 5 1 36 5 5 5 
48 49 50 5 37 3 5 5 5 5 51 32 32 56 5 5 54 32 32 53 5 5 5 5 11 36 5 5 5 5 
51 32 53 21 23 37 13 5 5 5 48 32 56 5 5 5 51 32 32 53 5 5 5 1 36 21 23 5 5 5 
54 55 21 25 25 23 37 13 5 51 32 32 53 5 5 5 5 54 32 50 5 5 1 36 21 25 25 23 5 5 
5 21 25 25 25 25 23 6 5 5 54 32 53 5 5 30 5 54 32 32 53 5 14 21 25 20 25 25 23 5 
5 27 25 25 20 25 29 6 5 5 5 55 5 5 5 5 5 5 54 32 56 5 14 27 25 25 25 25 29 5 
5 5 27 25 25 29 39 9 5 5 51 49 49 50 5 5 5 5 49 56 5 5 17 38 27 25 25 29 49 50 
5 5 5 27 29 39 19 5 5 5 48 32 32 53 5 5 5 48 32 50 49 5 5 7 38 27 29 51 32 53 
5 5 5 5 39 9 5 5 5 54 32 32 32 50 49 5 51 32 32 32 32 53 5 5 17 38 5 51 55 56 
5 5 5 39 19 48 5 5 5 5 54 32 32 32 32 56 54 32 32 32 56 5 5 5 5 7 38 5 5 5 
5 5 39 9 48 32 32 56 5 5 5 5 54 55 56 5 5 54 32 56 5 5 49 5 5 5 17 38 5 5 
5 39 19 5 54 32 56 5 50 5 5 5 5 5 5 5 5 5 55 5 5 48 32 50 5 5 5 7 38 5 
39 9 5 5 5 56 48 49 32 53 5 5 5 1 12 12 13 5 5 5 5 54 32 32 50 5 5 5 17 38 
19 5 5 5 5 51 32 32 32 53 5 5 11 36 21 23 37 3 5 5 5 5 54 32 56 5 5 5 5 7 
48 48 50 5 5 54 55 55 55 56 5 11 36 21 25 25 23 37 13 5 5 5 5 54 5 5 5 49 49 49 
32 32 56 5 5 5 5 5 5 5 11 36 21 25 25 20 25 23 37 3 5 5 5 5 5 5 5 54 32 32 
32 56 5 5 5 5 5 5 5 11 36 5 27 25 25 25 25 29 5 37 13 5 5 5 5 5 5 5 54 32 
56 5 5 5 48 53 5 5 11 36 48 49 50 27 25 25 29 5 5 5 37 3 5 5 51 50 5 5 5 54 
5 5 5 48 32 53 5 11 36 5 51 32 53 5 27 29 5 5 5 5 5 37 13 5 51 32 50 5 5 5 
5 5 48 32 32 53 11 36 5 5 5 55 5 5 5 5 5 5 5 5 5 5 37 13 51 32 32 50 5 5 
01110000
0 0 0 0 0 0 1 2 3 3 3 3 3 4 5 5 4 3 3 3 3 3 2 1 0 0 0 0 0 0 
0 0 0 0 0 0 0 1 2 3 3 3 3 3 6 6 3 3 3 3 3 2 1 0 0 0 0 0 0 0 
0 0 0 0 0 0 0 0 1 2 3 3 3 6 6 6 6 3 3 3 2 1 0 0 0 0 0 0 0 0 
0 0 0 0 0 0 0 0 0 1 2 2 6 6 6 6 6 6 2 2 1 0 0 0 0 0 0 0 0 0 
0 0 0 0 0 0 0 0 0 0 9 9 6 6 7 6 6 6 9 9 0 0 0 0 0 0 0 0 0 0 
0 0 0 0 0 0 0 0 0 0 0 9 9 6 6 6 6 9 9 0 0 0 0 0 0 0 0 0 0 0 
1 0 0 0 0 0 0 0 0 0 0 0 9 9 6 6 9 9 0 0 0 0 0 0 0 0 0 0 0 1 
2 1 0 0 0 0 0 0 0 0 0 0 0 9 9 9 9 0 0 0 0 0 0 0 0 0 0 0 1 2 
3 2 1 0 0 0 0 0 0 0 0 0 0 0 0 0 0 0 0 0 0 0 0 0 0 0 0 1 2 3 
3 3 2 1 0 0 0 0 0 0 0 0 0 0 0 0 0 0 0 0 0 0 0 0 0 0 1 2 3 3 
3 3 3 2 9 0 0 0 0 0 0 0 0 0 1 1 0 0 0 0 0 0 0 0 0 9 2 3 3 3 
3 3 3 2 9 9 0 0 0 0 0 0 0 1 2 2 1 0 0 0 0 0 0 0 9 9 2 3 3 3 
3 3 3 6 6 9 9 0 0 0 0 0 1 2 2 2 1 0 0 0 0 0 0 9 9 6 6 3 3 3 
4 3 6 6 6 6 9 9 0 0 0 0 1 2 2 2 2 1 0 0 0 0 9 9 6 6 6 6 3 4 
5 6 6 6 6 6 6 9 0 0 0 0 1 2 2 3 2 1 0 0 0 0 9 6 6 7 6 6 6 5 
5 6 6 6 7 6 6 9 0 0 0 1 2 2 2 2 2 2 1 0 0 0 9 6 6 6 6 6 6 5 
4 3 6 6 6 6 9 9 0 0 0 1 1 1 2 2 2 2 1 1 0 0 9 9 6 6 6 6 3 4 
3 3 3 6 6 9 9 0 0 0 0 0 0 1 0 2 2 1 0 0 0 0 0 9 9 6 6 3 3 3 
3 3 3 2 9 9 0 0 0 0 0 0 0 1 1 1 1 0 0 0 0 0 0 0 9 9 2 3 3 3 
3 3 3 2 9 0 0 0 0 0 0 0 0 0 0 1 1 0 0 0 0 0 0 0 0 9 2 3 3 3 
3 3 2 1 0 0 0 0 0 0 0 0 0 0 0 0 0 0 0 0 0 0 0 0 0 0 1 2 3 3 
3 2 1 0 0 0 0 0 0 0 0 0 0 0 0 0 0 0 0 0 0 0 0 0 0 0 0 1 2 3 
2 1 0 0 0 0 0 0 0 0 0 0 0 9 9 9 9 0 0 0 0 0 0 0 0 0 0 0 1 2 
1 0 0 0 0 0 0 0 0 0 0 0 9 9 6 6 9 9 0 0 0 0 0 0 0 0 0 0 0 1 
0 0 0 0 0 0 0 0 0 0 0 9 9 6 6 6 6 9 9 0 0 0 0 0 0 0 0 0 0 0 
0 0 0 0 0 0 0 0 0 0 9 9 6 6 6 7 6 6 9 9 0 0 0 0 0 0 0 0 0 0 
0 0 0 0 0 0 0 0 0 1 2 2 6 6 6 6 6 6 2 2 1 0 0 0 0 0 0 0 0 0 
0 0 0 0 0 0 0 0 1 2 3 3 3 6 6 6 0 3 3 3 2 1 0 0 0 0 0 0 0 0 
0 0 0 0 0 0 0 1 2 3 3 3 3 3 6 6 3 3 3 3 3 2 1 0 0 0 0 0 0 0 
0 0 0 0 0 0 1 2 3 3 3 3 3 4 5 5 4 3 3 3 3 3 2 1 0 0 0 0 0 0 
01111010
4 6 6 23 23 
4 24 24 24 24 
4 24 24 5 5 
4 4 4 4 4 
4 2 5 14 15 
4 14 15 1 5 
4 23 28 14 15 
4 14 15 23 28 
01101010
2 27
6 27
3 23
9 25
5 20
27 27
26 23
22 26
23 19
19 22
27 2
23 3
26 6
20 6
23 10
2 2
6 3
3 6
10 6
6 10
01100101
1 2 14 29 0
1 5 15 26 0
1 6 14 25 0
1 1 11 22 0
1 1 17 22 0
1 4 15 21 0
1 4 18 21 0
1 1 7 18 0
1 2 14 18 0
1 5 15 18 0
1 5 13 17 0
1 1 21 17 0
1 2 13 16 0
1 5 14 16 0
1 5 16 16 0
1 4 20 16 0
1 5 3 15 0
1 4 9 15 0
1 5 13 15 0
1 2 16 15 0
1 6 25 15 0
1 2 29 15 0
1 6 4 14 0
1 3 12 14 0
1 3 13 14 0
1 2 14 14 0
1 3 16 14 0
1 5 17 14 0
1 5 26 14 0
1 2 0 13 0
1 4 9 13 0
1 5 14 13 0
1 2 16 13 0
1 5 17 13 0
1 4 20 13 0
1 3 14 12 0
1 5 15 12 0
1 1 22 12 0
1 1 8 10 0
1 4 15 9 0
1 1 11 7 0
1 1 17 7 0
1 6 15 4 0
1 5 14 3 0
1 2 15 0 0
2 5 1 28 1
2 5 28 28 2
2 2 24 24 2
2 2 6 23 1
2 2 24 5 3
2 2 4 4 4
2 5 1 1 4
2 5 28 1 3
01111011
1 7 27
1 23 27
3 15 26
4 9 25
4 20 24
4 28 23
1 27 22
1 3 21
7 9 21
2 15 21
5 18 21
4 5 19
7 22 19
6 14 18
3 15 18
3 13 17
6 13 16
3 14 16
3 16 16
2 20 16
3 3 15
2 9 15
3 13 15
6 16 15
8 12 14
8 13 14
6 14 14
8 16 14
3 17 14
3 26 14
5 9 13
3 14 13
6 16 13
3 17 13
5 20 13
8 14 12
3 15 12
7 8 10
2 15 9
4 25 9
4 3 8
7 19 7
1 27 7
1 1 6
4 21 5
4 8 4
3 14 3
1 6 1
1 23 1
7777
Piraci powiedzieli, że skarb znajduje się w miejscu, które na mapie oznaczone zostało jako X
Okazuje się jednak, że cała połać terenu jest wielkim Iksem! Skarb musi gdzieś tu być, tylko gdzie?