25
25
0 0 0 0 0 0 0 0 0 0 0 0 0 0 0 0 0 0 0 0 0 0 0 0 0
0 10 5 5 5 5 5 5 5 5 5 5 5 5 5 5 5 5 5 5 5 5 5 10 0
0 5 5 5 5 5 5 5 5 5 5 5 20 5 5 5 5 5 5 5 5 5 5 5 0
0 5 5 5 5 5 5 5 5 5 5 5 5 5 5 5 5 5 5 5 5 5 5 5 0
0 5 5 5 5 5 5 5 49 0 5 5 5 5 5 0 49 5 5 5 5 5 5 5 0
0 5 5 5 5 5 5 48 32 53 1 2 2 2 3 51 32 50 5 5 5 5 5 5 0
0 5 5 5 5 5 48 32 56 1 36 5 5 5 37 3 54 32 50 5 5 5 5 5 0
0 5 5 5 5 48 32 56 1 36 5 5 5 5 5 37 3 54 32 50 5 5 5 5 0
0 5 5 5 51 32 56 1 1 2 41 12 12 12 42 2 3 3 54 32 53 5 5 5 0
0 5 5 5 0 52 1 36 4 5 4 5 5 5 6 5 6 37 3 55 0 5 5 5 0
0 5 5 5 5 1 36 5 40 2 36 5 5 5 37 2 43 5 37 3 5 5 5 5 0
0 5 5 5 5 4 5 5 14 5 5 5 5 5 5 5 16 5 5 6 5 5 5 5 0
0 5 20 5 5 4 5 5 14 5 5 5 30 5 5 5 16 5 5 6 5 5 20 5 0
0 5 5 5 5 4 5 5 14 5 5 5 5 5 5 5 16 5 5 6 5 5 5 5 0
0 5 5 5 5 7 38 5 45 8 38 5 5 5 39 8 46 5 39 9 5 5 5 5 0
0 5 5 5 0 49 7 38 4 5 4 5 5 5 6 5 6 39 9 49 0 5 5 5 0
0 5 5 5 51 32 50 7 7 8 44 18 18 18 47 8 9 9 48 32 53 5 5 5 5 0
0 5 5 5 5 54 32 50 7 38 5 5 5 5 5 39 9 48 32 56 5 5 5 5 0
0 5 5 5 5 5 54 32 50 7 38 5 5 5 39 9 48 32 56 5 5 5 5 5 0
0 5 5 5 5 5 5 54 32 53 7 8 8 8 9 51 32 56 5 5 5 5 5 5 0
0 5 5 5 5 5 5 5 55 0 5 5 5 5 5 0 55 5 5 5 5 5 5 5 0
0 5 5 5 5 5 5 5 5 5 5 5 5 5 5 5 5 5 5 5 5 5 5 5 0
0 5 5 5 5 5 5 5 5 5 5 5 20 5 5 5 5 5 5 5 5 5 5 5 0
0 10 5 5 5 5 5 5 5 5 5 5 5 5 5 5 5 5 5 5 5 5 5 10 0
0 0 0 0 0 0 0 0 0 0 0 0 0 0 0 0 0 0 0 0 0 0 0 0 0
01110000
0 0 0 0 0 0 0 0 0 0 0 0 0 0 0 0 0 0 0 0 0 0 0 0 0
0 0 0 0 0 0 0 0 0 0 0 0 0 0 0 0 0 0 0 0 0 0 0 0 0
0 0 0 0 0 0 0 0 0 0 0 0 0 0 0 0 0 0 0 0 0 0 0 0 0
0 0 0 0 0 0 0 0 0 0 0 0 0 0 0 0 0 0 0 0 0 0 0 0 0
0 0 0 0 0 0 0 0 0 0 0 0 0 0 0 0 0 0 0 0 0 0 0 0 0
0 0 0 0 0 0 0 0 0 0 1 1 1 1 1 0 0 0 0 0 0 0 0 0 0
0 0 0 0 0 0 0 0 0 1 1 1 1 1 1 1 0 0 0 0 0 0 0 0 0
0 0 0 0 0 0 0 0 1 1 1 1 1 1 1 1 1 0 0 0 0 0 0 0 0
0 0 0 0 0 0 0 1 2 2 3 3 3 3 3 2 2 1 0 0 0 0 0 0 0
0 0 0 0 0 0 1 1 2 2 3 3 3 3 3 2 2 1 1 0 0 0 0 0 0
0 0 0 0 0 1 1 1 3 3 3 3 3 3 3 3 3 1 1 1 0 0 0 0 0
0 0 0 0 0 1 1 1 3 3 3 3 3 3 3 3 3 1 1 1 0 0 0 0 0
0 0 0 0 0 1 1 1 3 3 3 3 3 3 3 3 3 1 1 1 0 0 0 0 0
0 0 0 0 0 1 1 1 3 3 3 3 3 3 3 3 3 1 1 1 0 0 0 0 0
0 0 0 0 0 1 1 1 3 3 3 3 3 3 3 3 3 1 1 1 0 0 0 0 0
0 0 0 0 0 0 1 1 2 2 3 3 3 3 3 2 2 1 1 0 0 0 0 0 0
0 0 0 0 0 0 0 1 2 2 3 3 3 3 3 2 2 1 0 0 0 0 0 0 0
0 0 0 0 0 0 0 0 1 1 1 1 1 1 1 1 1 0 0 0 0 0 0 0 0
0 0 0 0 0 0 0 0 0 1 1 1 1 1 1 1 0 0 0 0 0 0 0 0 0
0 0 0 0 0 0 0 0 0 0 1 1 1 1 1 0 0 0 0 0 0 0 0 0 0
0 0 0 0 0 0 0 0 0 0 0 0 0 0 0 0 0 0 0 0 0 0 0 0 0
0 0 0 0 0 0 0 0 0 0 0 0 0 0 0 0 0 0 0 0 0 0 0 0 0
0 0 0 0 0 0 0 0 0 0 0 0 0 0 0 0 0 0 0 0 0 0 0 0 0
0 0 0 0 0 0 0 0 0 0 0 0 0 0 0 0 0 0 0 0 0 0 0 0 0
0 0 0 0 0 0 0 0 0 0 0 0 0 0 0 0 0 0 0 0 0 0 0 0 0
01111010
4 3 3 3 3
4 3 3 21 21
4 21 21 21 21
4 21 21 3 3
1 2 6 10 13
1 10 14 2 6
1 10 14 18 21
1 18 22 10 13
3 2 6 10 13
3 10 14 2 6
3 10 14 18 21
3 18 22 10 13
3 2 6 10 13
3 10 14 2 6
3 10 14 18 21
3 18 22 10 13
5 10 14 10 14
01101010
3 2
2 3
2 1
1 2
4 4
21 22
22 21
22 23
23 22
20 20
3 22
2 21
1 22
2 23
4 20
22 3
21 2
22 1
23 2
20 4
01100101
1 1 3 10 0
1 1 1 10 0
1 1 10 21 0
1 1 10 23 0
1 1 21 14 0
1 1 23 14 0
1 1 14 3 0
1 1 14 1 0
1 3 9 15 0
1 3 15 9 0
1 3 9 9 0
1 3 15 15 0
2 0 2 2 1
2 2 3 3 1
2 0 22 22 2
2 2 21 21 2
2 0 2 22 3
2 2 3 21 3  
2 0 22 2 4
2 2 21 3 4  
7777