21
21
5 5 5 5 5 5 5 5 5 5 5 5 5 5 5 5 5 5 5 5 5 
5 5 5 5 5 5 5 5 5 5 5 5 5 5 5 5 5 5 5 5 5 
5 5 5 5 5 5 5 5 5 5 5 5 5 5 5 5 5 5 5 5 5 
5 5 5 5 5 5 5 5 5 5 5 5 5 5 5 5 5 5 5 5 5 
5 5 5 5 5 5 5 5 5 5 5 5 5 5 5 5 5 5 5 5 5 
5 5 5 5 5 5 5 5 5 5 5 5 5 5 5 5 5 5 5 5 5 
5 5 5 5 5 5 5 5 5 5 5 5 5 5 5 5 5 5 5 5 5 
5 5 5 5 5 5 5 5 5 5 5 5 5 5 5 5 5 5 5 5 5 
5 5 5 5 5 5 5 5 5 5 5 5 5 5 5 5 5 5 5 5 5 
5 5 5 5 5 5 5 5 5 11 13 5 5 5 5 5 5 5 5 5 5 
5 5 5 5 5 5 5 5 5 14 16 5 5 5 5 5 5 5 5 5 5 
5 5 5 5 5 5 5 5 5 14 16 5 5 5 5 5 5 5 5 5 5 
5 5 5 5 5 5 5 5 5 14 16 5 5 5 5 5 5 5 5 5 5 
5 5 5 5 5 5 5 5 5 14 16 5 5 5 5 5 5 5 5 5 5 
5 5 5 5 5 5 5 5 5 14 16 5 5 5 5 5 5 5 5 5 5 
5 5 5 5 5 5 5 5 5 14 16 5 5 5 5 5 5 5 5 5 5 
0 0 0 0 0 0 5 5 5 14 16 5 5 5 5 5 5 5 5 5 5 
0 0 0 30 5 5 5 5 5 17 19 5 5 5 5 5 5 5 5 5 5 
0 0 5 5 5 5 20 0 5 5 5 5 5 5 5 5 5 5 5 5 5 
0 0 0 0 0 0 0 0 5 5 5 5 5 5 5 5 5 5 5 5 5 
0 0 0 0 0 0 0 0 0 5 5 5 5 5 5 5 5 5 5 5 5 
01110000
0 0 0 0 0 0 0 0 0 0 0 0 0 0 0 0 0 0 0 0 0 
0 0 0 0 0 0 0 0 0 0 0 0 0 0 0 0 0 0 0 0 0 
0 0 0 0 0 0 0 0 0 0 0 0 0 0 0 0 0 0 0 0 0 
0 0 0 0 0 0 0 0 0 0 0 0 0 0 0 0 0 0 0 0 0 
0 0 0 0 0 0 0 0 0 0 0 0 0 0 0 0 0 0 0 0 0 
0 0 0 0 0 0 0 0 0 0 0 0 0 0 0 0 0 0 0 0 0 
0 0 0 0 0 0 0 0 0 0 0 0 0 0 0 0 0 0 0 0 0 
0 0 0 0 0 0 0 0 0 0 0 0 0 0 0 0 0 0 0 0 0 
0 0 0 0 0 0 0 0 0 0 0 0 0 0 0 0 0 0 0 0 0 
0 0 0 0 0 0 0 0 0 1 1 0 0 0 0 0 0 0 0 0 0 
0 0 0 0 0 0 0 0 0 1 1 0 0 0 0 0 0 0 0 0 0 
0 0 0 0 0 0 0 0 0 1 1 0 0 0 0 0 0 0 0 0 0 
0 0 0 0 0 0 0 0 0 1 1 0 0 0 0 0 0 0 0 0 0 
0 0 0 0 0 0 0 0 0 1 1 0 0 0 0 0 0 0 0 0 0 
0 0 0 0 0 0 0 0 0 1 1 0 0 0 0 0 0 0 0 0 0 
0 0 0 0 0 0 0 0 0 1 1 0 0 0 0 0 0 0 0 0 0 
0 0 0 0 0 0 0 0 0 1 1 0 0 0 0 0 0 0 0 0 0 
0 0 0 0 0 0 0 0 0 1 1 0 0 0 0 0 0 0 0 0 0 
0 0 0 0 0 0 0 0 0 0 0 0 0 0 0 0 0 0 0 0 0 
0 0 0 0 0 0 0 0 0 0 0 0 0 0 0 0 0 0 0 0 0 
0 0 0 0 0 0 0 0 0 0 0 0 0 0 0 0 0 0 0 0 0 
01111010
5 2 2 2 2
5 2 2 2 2
01101010
6 3
7 3
8 3
6 4
7 4
15 17
16 17
17 17
18 17
19 17
0 20
1 19
0 18
1 17
0 16
1 20
0 19
1 18
0 17
1 16
01100101
1 1 6 8 0
1 1 7 8 0
1 1 8 8 0
2 5 15 16 2
2 2 2 2 1
2 5 5 2 1
7777
